1111111111111111111111111111111111111111111111111111111
1000000000000000000000000000000000000000000000000000001
100C0000C00CCCCC00CCCCC0000CCCCC0000CCCCCC000C00000C001
100C0000C0000C0000C0000C000C0000C000C00000000CC0000C001
100C0000C0000C0000C00000C00C00000C00C00000000C0C000C001
1P0CCCCCC0000C0000C00000C00C00000C00CCCCC0000C00C00C0E1
100C0000C0000C0000C00000C00C00000C00C00000000C000C0C001
100C0000C0000C0000C0000C000C0000C000C00000000C0000CC001
100C0000C00CCCCC00CCCCC0000CCCCC0000CCCCCC000C00000C001
1000000000000000000000000000000000000000000000000000001
1111111111111111111111111111111111111111111111111111111
