111111111111111
1000010000000C1
100000011111001
100C00011111001
100000000000001
100000000111001
100000011111001
1P000011E000001
111111111111111
