11111
11C01
1P001
1E1C1
11111
