11111111111111111111111111111111111111111111111111
100000000000000000000000000000000000000000000000P1
10111111111111111111111111111111111111111111111101
1000000C000000000000000000000000000000000000000001
11111111111111111000000000000000000000000000000001
10000000000000001011111111111111111111111111111111
10111111111111101000000000000000000000000000000001
10000000000000101011111111111111111111111111111101
11111111111111101000000000000000000000000000000001
10000000000000001011111111111111111111111111111111
10111111111111111000000000000000000000000000000001
10000000000000000011111111111111111111111111111101
1111111111111110100000000000001C000000000000000001
10000001000000001011111111111111111111111111111111
10111111111111101000000000000000000000000000000001
10000000000000101011111111111111111111111111111101
11111111111110101000000000000000000000000000000001
10000000000000100011111111111111111111111111111111
10111111111111101000000000000000000000000000000001
10000000C00000101011111111111111111111111111111101
10111111111111101000000000000000000000000000000001
100000000000000010000000000C0000000000000000000001
11111111111111111000000000000000000000000000000001
100000000000000000000000000000000000000000000000E1
11111111111111111111111111111111111111111111111111
