1111111
1111111
11P0001
1000C01
10C0E01
1111111
