1111
1P01
1C01
1001
11E1
1111
