1111111111111
10011C0000001
1000011111001
1P00110000001
1111111111111
