111111111111111
100000000000001
100C00000000001
100011110E00001
100011110000001
100011110000001
100010010010001
10C000000010C01
100000P00010001
111111111111111
