1111111
1100001
1011C01
10C0EP1
1111111
