11111
11CO1
1P001
1E1C1
11111
